7
6
######
#    #
# @  #
# $  #
#    #
#    #
######