7
6
######
#    #
#    #
# $  #
# @  #
#    #
######