9
9
 #####   
 #   ####
 #   #  #
 ##    $#
### ###?#
# @ ###?#
#   #####
#   #####
#####    