11
11
   ###     
  ## # ####
 ## A###  #
## @      #
#    @ #  #
### @###  #
  #  #oo  #
 ## ##o# ##
 #      ## 
 #     ##  
 #######   