9
9
 #####   
 #   ####
 #   #  #
 ## A@ o#
### ###?#
# @ ###o#
#   #####
#   #####
#####    