7
6
######
#    #
# A  #
# ?  #
#    #
#    #
######