8
9
######   
###   #  
#   # ## 
# # @ o #
#    # # 
## #   # 
 #A  ### 
 #####   