7
6
######
#A   #
# @  #
# o  #
#    #
#    #
######